as....0....0....
dw....affffffs..
...0..r......r..
......r.0..0.r..
@ffs..r......df$
.0.r..r.....0...
...r.0r.0.......
...dffw.........
....0...........