.0.as..0......
...rr.........
@ffwdfsafsaff$
......rr.rr.0.
...0..dw0rds..
0........dfw0.