........0.....
..0..0...afs0.
@fffs.affw.df$
.0..dfw...0..0
.......0......
..............