........0.....
..0......afs0.
@fffs0affw0df$
.0..dfw......0
.......0......
..............