........0.....
.....0...afs0.
@fffs.affw.df$
.00.dfw...0...
.......0.....0
..............