0.....0.....0.
..............
@ffffffffffff$
..............
..0.....0.....
......0....0..